 --- --- --- --- --- --- --- --- --- 
|               |               | ^ |
     ---                 ---         
|           |           |       |   |
 ---             --- ---     ---     
|       |   | x |                   |
         ---     --- --- ---         
|   |                   |           |
         ---         ---     ---     
|   |           |                   |
 --- --- --- --- --- --- --- --- --- 