 --- --- --- --- --- --- --- --- --- 
|               |             <     |
     ---                 ---         
|           |           |   |       |
 ---             --- ---     ---     
|       | x |   |                   |
         ---     --- --- ---         
|   |                   |           |
         ---         ---     ---     
|   |           |           |       |
 --- --- --- --- --- --- --- --- --- 
